20
10
   ##J##  ##JJ##    
   #...####....#    
  ##...........##   
###.............####
J..................J
J..................J
###.............####
  ##...........##   
   #...####....#    
   ##J##  ##JJ##    
