(9.0, 9.0)
   #J#   
 ###.### 
 #.....# 
##.....##
J.......J
##.....##
 #.....# 
 ###.### 
   #J#   
0
