54
40
                ###########      ###                  
                #....#....#      #.#                  
         ###    #.~~...~~.#      #.#                  
         #.#  ###.~~.#.~~.####   #.#    #########     
         #.#  #...~~.#.~~....#   #.#    #.......#     
         #.#  ###.~~.#.~~.####   #.#    #.~~~~~.####  
        ##.###  #.~~...~~.#      #.#    #.~~~~~....#  
        #....#  #....#....#     ##.###  #.......####  
        #.~~.#  ###.###.### #####....#  ##.###.##     
        #.~~.#    #.# #.# ###.....~~.#  ##.###.##     
        #.~~.#    #.# #.# #.#####.~~.####.......#     
        #.~~.#    #.###.###.##  #.~~......~~~~~.#     
        #.~~.#    ####.......####.~~.####.~~~~~.####  
        #....#       #.~~~~~......~~.#  #..........#  
      ######.####  ###.~~~~~.####....#  ####.#######  
      #.........#  #.........#  ####.#     #.#        
    #####.~~~~~.#########.####  ####.#########        
    #.# #.~~~~~.....#   #.#     #..........#          
    #.# #.......#########.#######.~~~~~.#### ###      
   ##.####.###.####  #............~~~~~.#    #.#      
   #....#### #....####.~~~~~.####.......#    #.#      
   #.~~.#    #.~~......~~~~~.#  ##.###.#######.#      
   #.~~.######.~~.####.......#   ### #....#....#      
   #.~~........~~.#  ##.###.##       #.~~...~~.#      
   #.~~.######.~~.##  #.# #.#     ####.~~.#.~~.##     
   #.~~.#    #.~~..#  #.# #.#   ###....~~.#.~~..#     
   #....#    #....##  #.# #.#   #.####.~~.#.~~.##     
   ######    ###.##   #.# #.#   #.#  #.~~...~~.#      
               #.#    #.###.#####.## #....#....#      
               #.#    #.##....#....# ###.###.###      
               #.#    #.#..~~.#.~~.#   #.# #.#        
               #.#    #.##.~~.#.~~.#   #.# #.#        
            ####.#### #.##.~~...~~.#   #.# #.#        
            #.......# #.##.~~.#.~~.#   #.# #.#        
         ####.~~~~~.# #.#..~~.#.~~.#   #.# #.#        
         #....~~~~~.# #.##....#....#   #.# #.#        
         ####.......# #.#####.######   ### ###        
            ######### ###   #.#                       
                            #.#                       
                            ###                       
